XXXXXXXXXXXX
XWWWWWXWWWZX
XXXWXWWXWWXX
XWWWXWWWWWXX
XWXXXWXXXWWX
XWWWXWWWXWWX
XWWXXXWXWXWW
XWWXWWWXWWWW
XWWXWWWXXXWX
XSWWWWWWXWWX
XXXXXXXXXXXX
