XXXXXXXXXXXXXXXXXXXXXXXXX
XWWWWWWWWXWWWWWWWWWWWWWWX
XWWSWXXWWXWWXXWWWWWWWWWWX
XWWXWWWWWXWWWWWWWXXWWWWXX
XWWXWWXWWWWWWXWWWWWWWWWWX
XWWWWWWXWWWWXXWWWWXWWWWWX
XWWXWWWWWWWWWWWWWWXWWXWWX
XWWXWWWWXWWXWWWWWWWXWWWWX
XWWWWXWWWWWWWXXWWWWWWWWWX
XWWXXWWWXWWWWWWWWWWXWWXWX
XWWWWWWWWXWWWWXWWWWWWWWWX
XWWWXWWWWWWWWWWXXWWWWWWWX
XWWWXWWWXWWXWWWWWWWWWWXWX
XWWWWWWWXWWWWWWWXWWWWWWWX
XWWXWWXWWWWWWWWWWWXWWWWWX
XWWWWXWWWWXXWWWWWWWWWWXWX
XWWWWWWWXWWWWWWWWWWWWXWWX
XWWXWWWWWWWWXWWXWWWWWWWWX
XWWWWWWXWWWWWWWWWWWXXWWWX
XWWXWWWWWWWWWWWWXWWWWWWWX
XWWWWXWWXWWWWWWWWWWWWXWWX
XWWWWWWWXXWWWWXWWWWWWWWWX
XWWWWWWWWWWWWWWXWWWWWWWWX
XWWWWWZWWWWWWWWWWWWWWWWWX
XXXXXXXXXXXXXXXXXXXXXXXXX
