XXXXXXXXXXXXXXXXXX
XWZWWWWWWXWWWWWWWX
XWWWWWXXWXWWWWXXWX
XWWXWWWWWWWXXXWWWX
XWWWXWWXWWWXWWXWWX
XWWXWWWXWWXWWXWWWX
XWWWWXWWXWWWWWWWWX
XWWWXXWWWWWXXWWWWX
XWWWWWWXWWWWWXWWWX
XWWXWWWWXWWWXWXWWX
XWWWWWXWWWWWWWXWWX
XWWXXWWWXWWXWWWWWX
XWWWXWWWWXWWWWWWWX
XWWWXXWWXWWWXXWWWX
XWWWWWWWWWWWWWWWXX
XWWWWWWXWWWXWWWSWX
XXXXXXXXXXXXXXXXXX
